1111111
1E00001
1P00001
1000EC1
1111111
