1111111
1PC0001
100C001
100P0E1
1111111
