1111111
1PC00011
100C001
10000E111
1111111
