1111111
1000001
1P00001
10000C1
1111111