1111111
10C0001
100C001
10000E1
1111111