111111
1P0001
10C001
100001
10C0E1
111111