1111111111111111111111111111111111111111
1000000000000000000F00000000000000000001
10000F000001000000000000000001C0001100F1
100000000001000P0000F0000000010000110001
100000C000010000000000000000010000110001
10011110000100F00000C0000000010000110001
1001E000F0010F00000000000000011111110001
1001111111110CF0000000000000000000000001
1000000000000F00000F00000000C10001111111
10000F0000000000000000000000010000000001
1000001111111111111111111111111111111101
1000000000000000000000000000F00000000001
1000000C0000F000000000000000000000000001
1000000000111111111111110000C00000000001
1000F00000000001C000000100000000000F0001
1000000000000000100000010000000000000001
1000000000000000010000010000000000000001
10000000F0000000001000011111111111100001
1000000000000000C00000000000C00000000001
1000000000000000C00000000000C00000000001
1000000000000000C00000000000C00000000001
1000000000000000C00000000000C00000000001
1000000000000000C00000000000C00000000001
1111111111111111111111111111111111111111
